NO path/north.xpm
EA path/east.xpm
SO path/south.xpm
WE path/west.xpm

C 225,30,0
F 0,0,255

11111111
100000N1
10000001
10000001
10000001
11111111
11111111
10000001
10001001
10000001
10000001
11111111