NO path/north.xpm
EA path/east.xpm
SO path/south.xpm
WE path/west.xpm


C 225,30,0
F 0,0,255      


       1111111111111111111111111
       1000000000110110000000011
       10110000011100100000000011111111
       10010000000000000000000111111111
111111111100000111000000111111000000111                    111      11111111
111111111111111111111111111111111101111                   101      111    101
100000000011000001110111111111111111111                  101 111         111
11110111111111011100000010001                           101  101       111 
11110111111111011101010010001                          1111110111   111
11000000110101011100000100011                                101    101
100000000000000011000N0010001                               111   11111111111
10000000000000000110100010001
10000000000000000110100010001
11001001110101011111111100111
11110111 1110101 11111010011
11111111 1111111 11111111111